####################
#@                 #
#############  $   #
            ###    #
              #   .#
              ######