####################
#                  #
#              $   #
#  @               #
#                 .#
####################